NO /home/oharoon/cub3d/textures/wall.xpm
SO /home/oharoon/cub3d/textures/w2.xpm
WE /home/oharoon/cub3d/textures/w.xpm
EA /home/oharoon/cub3d/textures/wall16.xpm

F 220,100,0
C 225,30,0


111111
100001
110001
100N0111111111111111111111111111111111111111111
10110000000000000000000000000000000000000000001
11010111111111111111111111111111111111111111001
10000000000000000000000000000000000000000000001
11111111111111111111111111111111111111111111111